/height 15
/width 20
/map_id entrance
/neighbour_east twist
~~~~~~~~############
~~~~~#.#############
~~~.......##########
~.........f..#######
~..............#####
~...............####
~...@....f...z...###
~.................##
#......f...z....z.##
#........z.....z...#
#...f...z....z...z.#
#.f..z.z..z.z...z...
#..z....z...z.z.....
#..........z.....###
####################

/height 15
/width 20
/map_id twist
/neighbour_west entrance
####################
###..##########....#
##.S.########......#
#....#.........S...#
#......#f####......#
#......#######.....#
##.############....#
###############f.###
###############..f##
##########...###...#
##R..^.z...z...#...#
@....^..z..L.z.....#
.R...^.z..z..L...###
#....^.z.L.z....####
####################

/height 15
/width 20
/map_id empty
####################
#..................#
#..................#
#....@.............#
#............f..z..#
#..................#
#.........f..z...z.#
#..................#
#......f...z.......#
#..............z...#
#...f...z....z.....#
#...........z...z..#
#..z....z..........#
#..................#
####################

