/height 15
/width 20
/map_id entrance
/neighbour_east twist
/on_entrance The robots may be numerous, but they are only empty chassis. Just keep your distance.
~~~~~~~~############
~~~~~#.#############
~~~.......##########
~.........f..#######
~..............#####
~...............####
~...@..r.f...z...###
~.................##
#...r..f...z....z.##
#........z.....z...#
#...f...z....z...z.#
#.f..z.z..z.z...z...
#..z....z...z.z.....
#..........z.....###
####################

/height 15
/width 20
/map_id twist
/neighbour_west entrance
/neighbour_north first_branch
/on_entrance Press 'z' to jump over tiles you'd rather not visit, like those landmines.
###.################
###..##########....#
##.S.###f#.........#
#....#.........G...#
#......#f####......#
#......#######.....#
##.############....#
###############r.###
###############..f##
##########...###...#
##R..^.z...z...#...#
@....^..z..L.z.....#
.R...^.z..z..L...###
#....^.z.L.z....####
####################

/height 15
/width 20
/map_id first_branch
/neighbour_south twist
/neighbour_west coast
/neighbour_east end
/on_entrance Nothing interesting to the west.
####################
####################
#########/----\.....
#########|...G|..S..
#########|.---/.z...
#########..##.....##
#######......z.#####
######........######
..#.###.....z.######
.....##......#######
##....#.z..|.#######
####......#|.--\####
###.....z##|..T|####
##.@..#####\---/####
###.################

/height 15
/width 20
/map_id coast
/neighbour_east first_branch
/on_entrance Nothing interesting at all. Told you so.
~~~~~~~~~~~~~~~#####
~~~~~~~~~~~~~.######
~~~~~~~~~~~~..######
~~~~~~~~~~......####
~~~~~~~........#####
~~~~~~~......#######
~~~~~~~~.#......####
~~~~~~...........###
~~~~~~..........@...
~~~~~~~....#........
~~~~~~~........#####
~~~~~~~~..##########
~~~~~~~~....########
~~~~~~.........#####
~~~~~~~#############

/height 15
/width 20
/map_id end
/neighbour_west first_branch
/on_entrance Thank you for playing the prototype! Please send me your suggestions and bug reports.
####################
####################
........##########.#
........../-------\#
..@.......|S.S.S.S|#
#.........|.......|#
##...|....\-.....-/#
####.|....|T.....G|#
#####|....|T.....G|#
#####|....\--...--/#
#####/-\..........|#
#####|S|....../---/~
#####|G......|####~~
#####\-------/##..~~
###############~~~~~

/height 15
/width 20
/map_id test
/on_entrance This is a test level. Please inform me if you see it
####################
#.........Gz.......#
#.........GG..S....#
#..................#
#.............S....#
#.r.r.r....zT......#
#/-.-\........S....#
#.@..|r....z.......#
#....|........S....#
#.....r............#
#....|........S....#
#....|r../----\....#
#....|...|....|....#
#..../r..\----/....#
####################

