/height 15
/width 20
####################
###..##########....#
##.S.########.......#
#....#.........S...#
#......#f####......#
#......#######.....#
##.############....#
###############f.###
###############..f##
##########...###...#
##R..^.z...z...#...#
@....^..z..L.z.....#
.R...^.z..z..L...###
#....^.z.L.z....####
####################