/height 15
/width 20
####################
#..................#
#..................#
#..S...............#
#..................#
#..................#
#..................#
###############....#
#..................#
#..................#
#..................#
#..@...............#
#..................#
#..................#
####################